MMMGGGMM
MGGTTTGM
MGGGGGGw
MGGGGGGw
MGGGGGWw
MMMMwwww
