MMMMMMMM
MGGGGGGM
MGTGGGGM
MGGGGGGM
MGGGGGWM
MMMMMMMM
