........
...123..
........
........
......W.
........
