........
...123..
........
........
.J....W.
........
